R 1000 10000
NO ./textures/1.xpm
SO ./textures/2.xpm
WE ./textures/3.xpm
EA ./textures/4.xpm
S ./textures/sprite2.xpm
F 000,100,0
C 255,255,255

        1111111111111111111111111
        1000000000110000000000001
        1011000001110000002000001
        1001000000000000000000001
1111111110110000011100000000N0001
100000000011000001110111111111111
11110111111111011100000010001
11110111111111011101010010001
11000000110101011100000010001
10002000000000001100000010001
10000000000000001101010010001
110000011101010111110111000011
11110111 1110101 101111010001
11111111 1111111 111111111111