R  1920 1080
NO ./textures/north.xpm
WE ./textures/west.xpm
EA ./textures/east.xpm
SO ./textures/south.xpm
S ./textures/sprite.xpm

F 230,10,1
C 255,30,255

1111111
1000001
1110N01
1000001
1111111