R  2550 1500
NO ./textures/north.xpm
WE ./textures/west.xpm
EA ./textures/east.xpm
SO ./textures/south.xpm
S ./textures/sprite.xpm
F 230,100,0
C 225,30,255

1111111111
11111
100N1
111
11111