R 1920 1080
NO ./textures/north.xpm
SO ./textures/south.xpm
WE ./textures/west.xpm
EA ./textures/east.xpm
S ./textures/sprite.xpm

F 220,100,0
C 225,30,0

11111111111111111111111111111111111111111
10000000000000000000000000000000000000001
11100001111111100000000000000110111110011
10000000000000000000000000000000000000001
10000000000000000N00000000000000000000001
11111111111111111111111111111111111111111