R  900 500
NO ./textures/north.xpm
WE ./textures/west.xpm
EA ./textures/east.xpm
SO ./textures/south.xpm
S ./textures/sprite.xpm

F 230,10,1
C 255,30,255

111111111111
1N0000000001
100000000001
100000000001
111111111111