R  1920 1024
NO ./textures/north.xpm
WE ./textures/west.xpm
EA ./textures/east.xpm
SO ./textures/south.xpm
S ./textures/sprite.xpm

F 230,10,1

C 255,30,255

111111111111111111
100001   1   1   1
1N0001   1   1   11111111111
100001   1   1   1
111111111111111111