R 2550 1237
NO ./textures/north.xpm
WE ./textures/west.xpm
EA ./textures/east.xpm
SO ./textures/south.xpm
S ./textures/sprite.xpm
F 230,100,0
C 225,30,250

111111
111111

1101111
11111
