R 1920 1080

NO ./textures/north.xpm
WE ./textures/west.xpm
EA ./textures/east.xpm
SO ./textures/south.xpm
S ./textures/sprite.xpm

C 190,0,0
F 115,115,115

        1111 11111111111111111111
        1001 1000110000000000001
        101110001110000002020001
        1001000000000000000000001
111111111011000001110000000200001
100000001011000001110111111111111
11110111111111011000000010001
11110111111111011101010010001
11000000110121011100000010001
10002000000202001100002000001
10000000N00020001101010010001
1100000111010101111101111000111
11110111 1110101 101111110001
11111111 1111111 111111111111