R 2550 150
NO ./textures/north.xpm
WE ./textures/west.xpm
EA ./textures/east.xpm
SO ./textures/south.xpm
S ./textures/sprite.xpm
F 230,100,0
C 225,30,255











1111
10N01
11111